20
**************#**************************
**************#**************************
**************#################**********
*****************************************
*****************************************
***********#######***********************
*****************************************
*****************************************
*****************************************
*******************#################*****
*****************************************
*****************************************
*******####################**************
*****************************************
*****************************************
*****************************************
********####################*************
*****************************************
*****************************************
*****************************************