20
#########################################
#****************************************
#****************************************
#***************************************#
#***************************************#
#***************************************#
#***************************************#
#***************************************#
#***************************************#
#***************************************#
#***************************************#
#***************************************#
#***************************************#
#***************************************#
#***************************************#
#***************************************#
#***************************************#
#***************************************#
#***************************************#
#########################################