20
#########################################
##***************************************
#*#**************************************
#**#*************************************
#***#***********************************#
#****#**********************************#
#*****#*********************************#
#******#********************************#
#*******#*******************************#
#***************************************#
#***************************************#
#***************************************#
#***************************************#
#***************************************#
#***************************************#
#***************************************#
#***************************************#
#***************************************#
#***************************************#
#########################################